1111111111
1A000000C1
100C000001
1000000001
1111111101
1000000001
1010000001
1010000101
1010000101
1E1C0001P1
1111111111
